█████████████████████
^     █     █       █
███ █ █ ███ █ █ ███ █
█   █ █ █   █ █   █ █
█ █████ █ █████ █ ███
█     █ █     █ █   █
█ ███ █ █████ █████ █
█ █   █ █   █ █   █ █
█ █ ███ █ ███ █ █ █ █
█ █   █ █   █ █ █   █
█ ███ █ ███ █ █ ███ █
█ █ █ █   █ █ █   █ █
█ █ █ ███ █ █ █ █ ███
█ █ █   █ █ █ █ █   █
█ █ ███ ███ █ █████ █
█   █ █     █       █
███ █ █████ ███████ █
█   █     █   █   █ █
█ █████ █ █ ███ █ █ █
█       █ █     █    
█████████████████████